%%%%%%%%%%%%%%%%%
%P      %       %
% % % % % %%%%% %
% % % % % %   % %
% %%%%% % %   % %
%     %   % %%% %
%%%%% %%% %     %
%       % % %%% %
% %%%   % % % %%%
% % %%% % %    .%
% %   % %%% %%%%%
% % % % %   %   %
%%% %%% % %%%%% %
%       G       %
%%%%%%%%%%%%%%%%%